#####################
#     #             X
# P   #             X
#     #   E #       #
#     #     #       #
#  ##########       #
#                   #
#                   #
#                   #
#                ####
#      E    #       #
#           #       #
######   ####       #
#                   #
#               E   #
#    E              #
#                   #
#####################