#################################
#        #  E      #    #       X
#        #         #    #  E    X
#        #    #    #            #
#    #     E  #                 #
# P  #        #  E      #   E   #
#################################