#############################
# P                     E   #
#                           #
##################   #      #
#                # E #      #
#########        #####      #
X       #            ###    #
X    E  #    #####   #      #
#       #    #   #####      #
#     ###    # E            #
#       #    #            ###
#   E   #    #########      #
#       #            #      #
###     #####        #   E  #
#           #        #      #
#  E        ############    #
#      # E     E            #
#      #                    #
#############################